1000000000001
1000000000002
1000000000003
1000000000004
1000000000005
1000000000006
1000000000007
1000000000008
1000000000009
1000000000010
1000000000011
1000000000012
1000000000013
1000000000014
1000000000015
1000000000016